not-auto
wwwwwwwwwwwwwww
ww-----------ww
w-------------w
w-------------w
wg------------w
wwwfffffffw---w
wwwwwwwwwww---w
ww------------w
w-------------w
w-------------w
w-------------w
w---wwfffffffww
w---wwwwwwwwwww
w------------ww
w-------------w
w-------------w
wwwwffffffw---w
wwwwwwwwwww---w
ww------------w
w-------------w
w-------------w
w-p-----------w
w-------------w
wwwwwwfffffffww
wwwwwwwwwwwwwww