not-auto
wwwwwwwwwwwwwwwwww
w----------------w
w----------------w
w----------------w
w----------------w
w----------------w
w----------------w
w--------------www
w-p-----w------w-w
w-------------w--w
wwwwwwwwwwwwwwwwww